1 1
3 5
########
#      #
###### #
#    # #
# ## # #
# #  # #
# #### #
#      #
########