1 1
3 3
#######
#     #
##### #
#   # #
# ### #
#     #
#######