1 1
20 9
############################
#                          #
########################## #
#                        # #
# ###################### # #
# #                    # # #
# # ################## # # #
# # #                # # # #
# # # ############## # # # #
# # # ############## # # # #
# # # ################ # # #
# # #                  # # #
# # #################### # #
# #                      # #
# ######################## #
#                          #
############################